
名称	大小	修改日期
[上级目录]		
lbmExampleUtil.cs	Helper library
lbmhfxrcv.cs	    Receive messages via a HFX.
lbmimsg.cs	        Send immediate messages on a single topic or send topic-less messages

lbmlatping.cs	21.2 kB	13/6/26 下午5:15:04
lbmlatpong.cs	12.8 kB	13/6/26 下午5:15:04

lbmmon.cs           Example LBM statistics monitoring application.
lbmmrcv.cs	        Receive messages on multiple topics.
lbmmsrc.cs	        Send messages on multiple topics.
lbmpong.cs	        Message round trip processor.
lbmrcv.cs	        Receive messages on a single topic.
lbmreq.cs	        Send request messages from a single source with setttable interval between messages.
lbmresp.cs	        Respond to request messages on a single topic.
lbmsrc.cs	        Send messages on a single topic.

lbmStatistics.cs	15.7 kB	13/6/26 下午5:15:04

lbmtrreq.cs	        Request topic resolution for quiescent components.
lbmwrcv.cs	        Receive messages using a wildcard receiver.
MinRcv.cs	        Minimum code of a receiver
MinSrc.cs	        Minimum code of a sender

VerifiableMessage.cs	3.6 kB	13/6/26 下午5:15:04

umeblock.cs         Send messages on a single topic by using a blocking send call.
umercv.cs           Receive messages on a single topic.
umesrc.cs           Send messages on a single topic.